impecunious	poor
necessitous	poor
penurious	poor
aridity	poverty
exiguity	poverty
indigence	poverty
paucity	poverty
penury	poverty
privation	poverty
straits	poverty
inimical	unfriendly
dyspeptic	unfriendly
acrimonious	unfriendly
censorious	unfriendly
uncongenial	unfriendly
unpropitious	unfriendly
invidious	unfriendly
impugn	criticize
polemic	criticize
asperse	criticize
calumniate	criticize
castigate	criticize
malign	criticize
traduce	criticize
upbraid	criticize
censure	criticize
baste	criticize
drub	criticize
excoriate	criticize
rebuke	criticize
reprehend	criticize
objurgate	criticize
remonstrate	criticize
vituperate	criticize
fulminate	criticize
reprove	criticize
fractious	rebellious
contumacious	rebellious
seditious	rebellious
bellicose	rebellious
iconoclastic	rebellious
obstinate	rebellious
pugnacious	rebellious
recalcitrant	rebellious
refractory	rebellious
dissident	rebellious
attenuate	weaken
enervate	weaken
vitiate	weaken
tawdry	gaudy
meretricious	gaudy
splendiferous	gaudy
gimcrack	gaudy
spurious	fake
ersatz	fake
listless	low energy
lassitude	low energy
enervated	low energy
impassive	low energy
indolent	low energy
insouciant	low energy
languid	low energy
lethargic	low energy
lymphatic	low energy
torpid	low energy
lachrymose	sorrowful
lugubrious	sorrowful
doleful	sorrowful
dolorous	sorrowful
plaintive	sorrowful
rueful	sorrowful
mordant	biting
poignant	biting
sardonic	biting
acerbic	biting
astringent	biting
acidulous	biting
trenchant	biting
approbation	praise
encomium	praise
panegyric	praise
accolade	praise
obeisance	praise
sycophancy	praise
plaudit	praise
laudation	praise
acclamation	praise
imprecation	curse
malediction	curse
anathema	curse
execration	curse
effrontery	audacity
gall	audacity
impertinence	audacity
impudence	audacity
temerity	audacity
chutzpah	audacity
insolence	audacity
pertness	audacity
hauteur	audacity
hubris	audacity
ostentation	audacity
cavalier	audacity
supercilious	audacity
stratagem	trickery
guile	trickery
chicanery	trickery
legerdemain	trickery
machination	trickery
chicane	trickery
duplicity	trickery
skullduggery	trickery
austere	stern
spartan	stern
flinty	stern
surfeit	excess
plenitude	excess
profuse	excess
profligate	excess
prodigal	excess
voluble	talkative
loquacious	talkative
garrulous	talkative
effusive	talkative
multiloquent	talkative
prolix	talkative
prattle	talkative
reticent	silent
laconic	silent
tacit	silent
silentious	silent
taciturn	silent
limpid	clear
diaphanous	clear
pellucid	clear
perspicuous	clear
gossamer	clear
halcyon	peaceful
irenic	peaceful
placid	peaceful
equable	peaceful
diurnal	daily
quotidian	daily
intransigent	stubborn
contumacious	stubborn
inexorable	stubborn
intractable	stubborn
mulish	stubborn
obdurate	stubborn
pertinacious	stubborn
tenacious	stubborn
unyielding	stubborn
moxie	courage
bravura	courage
elan	courage
gameness	courage
hardihood	courage
intrepidity	courage
mettle	courage
pluck	courage
pugnacity	courage
temerity	courage
intrepid	courage
pusillanimous	cowardly
craven	cowardly
dastardly	cowardly
recreant	cowardly
timorous	cowardly
augury	foresight
circumspect	foresight
portent	foresight
prognostication	foresight
canniness	foresight
circumspection	foresight
clairvoyance	foresight
precognition	foresight
prescience	foresight
sagacity	foresight
axiom	truth
rectitude	truth
verity	truth
veracity	truth
candor	truth
fidelity	truth
probity	truth
conciliate	appease
mitigate	appease
mollify	appease
propitiate	appease
placate	appease
abate	appease
allay	appease
ameliorate	appease
bonhomie	cheerful
airy	cheerful
jocund	cheerful
roseate	cheerful
winsome	cheerful
zappy	cheerful
quiescent	inactive
abeyant	inactive
indolent	lazy
dilatory	lazy
feckless	lazy
licentious	immoral
dissolute	immoral
nefarious	immoral
iniquitous	immoral
reprobate	immoral
saturnalian	immoral
wanton	immoral
stolid	unemotional
impassive	unemotional
phlegmatic	unemotional
itinerant	aimless
desultory	aimless
peripatetic	aimless
capricious	aimless
unavailing	aimless
vagrant	aimless
ambulant	aimless
nomadic	aimless
wayfaring	aimless
mendacious	dishonest
perfidious	dishonest
prevaricate	lie
canard	lie
garble	lie
equivocate	lie
palter	lie
calumny	slander
obloquy	slander
libel	slander
malign	slander
traduce	slander
nix	reject
rebuff	reject
repudiate	reject
abdicate	reject
disavow	reject
abjure	reject
contemn	reject
forswear	reject
dictum	command
edict	command
fiat	command
precept	command
requisition	command
writ	command
adjure	command
maudlin	sentimental
affected	sentimental
effusive	sentimental
bathetic	sentimental
mawkish	sentimental
schmalz	sentimental
insipid	unoriginal
jejune	unoriginal
bromide	unoriginal
prosaic	unoriginal
noisome	stinking
fetid	stinking
malodorous	stinking
mephitic	stinking
orotund	pompous
bombastic	pompous
fustian	pompous
imperious	pompous
pontifical	pompous
anodyne	soothing
analgesic	soothing
